4,5
######
#*   #
####!#
#    #
#!####
#    #
######